WE   cubfiles/xpm/p_ji_w_1.xpm
NO   cubfiles/xpm/p_ji_n_1.xpm
EA ./cubfiles/xpm/p_ji_e_1.xpm
SO ./cubfiles/xpm/p_ji_s_1.xpm

C 0,186,188
F 237, 129, 121

        1111111111111111111111111
        1000000000110000000000001
        1011000001110000000000001
        1001000000000000000000001
111111111011000001110000000000001
100000000011000001110111111111111
11110111111111011100000000001
11110111111111011101010000001
11000000110101011100000000001
10000000000000001100000001001
10000000000000001101010000001
11000001110101011111011100S01
11110111 1110101 101111010001
11111111 1111111 111111111111
