EA   cubfiles/xpm/p_ji_w_1.xpm
SO   cubfiles/xpm/p_ji_n_1.xpm
WE ./cubfiles/xpm/p_ji_e_1.xpm
NO ./cubfiles/xpm/p_ji_s_1.xpm

C 0,186,188
F 237, 129, 121
1111111
1000101
1100001
100S001
1000011
1010001
1111111
