SO cubfiles/xpm/p_ji_s_1.xpm
WE cubfiles/xpm/p_ji_w_1.xpm
NO cubfiles/xpm/p_ji_n_1.xpm
EA cubfiles/xpm/p_ji_e_1.xpm


C 3,178,200
F 0, 120, 255

111111111111111
101000100010001
101010101010101
1N001000100010
111111111111111
